p	p	P
b	b	B
t	t	T
d	d	D
k	k	K
g	g	G
f	f	F
v	v	V
θ	ŧ Ŧ
ð	đ	Đ
s	s	S
z	z	Z
ʃ	š	Š
ʒ	ž	Ž
h	h	H
tʃ c C
dʒ j J
m	m	M
n	n	N
ŋ	ň	Ň
l	l	L
ɹ	r	R
ɚ ěr Ěr
ɾ	ṙ	Ṙ
r	ř	Ř
w	w	W
j	y	Y
ʍ	ẇ	Ẇ
x	x	Z
ʔ	'	'
ɬ	ṣ	Ṣ
ɮ	ẓ	Ẓ
ɑ	a	A
ɒ	a	A
æ	ā	Ā
ɑ	ȧ	Ȧ
a	ä	Ä
ɛ	e	E
e	ė	Ė
ɜ	ȇ	Ȇ
ə	ě	Ě
i	i	İ
ɪ	ı	I
o	o	O
ɔ	ȯ	Ȯ
ʌ	ǒ	Ǒ
u	u	U
ʊ	ǔ	Ǔ
